... ... ... ... ... ... ... --- ... ... ... ... ... --- ... ... ... ... ... ... ...
... ... ... ... ... --- --- --- ... --- --- --- ... --- --- --- ... ... ... ... ...
... ... ... ... ... ... --- ()) --- -0- +-- --- --- ()) --- ... ... ... ... ... ...
... ... ... ... --- ### --- /\\ ()) --- --- --- ()) /\\ --- ### --- ... ... ... ...
... ... ... --- --- --- ()) --- --- $)) ### $)) --- --- ()) -1- --- --- ... ... ...
... --- ... ### -8- --- $)) +-- --- =-- =-- =-- --- +-- $)) --- --- ### ... --- ...
... --- --- --- ()) $)) ### =-- --- --- =-- --- --- =-- ### $)) ()) --- --- --- ...
--- --- ()) /\\ --- +-- =-- =-- ### ... =-- ... ### =-- =-- +-- --- /\\ ()) --- ---
... ... --- ()) --- --- --- ### =-- --- <>> --- =-- ### --- --- --- ()) --- ... ...
... --- --- --- $)) =-- --- ... --- <>> $\\ <>> --- ... --- =-- $)) --- -3- --- ...
... --- +-- --- ### =-- =-- =-- <>> $\\ $\\ $\\ <>> =-- =-- =-- ### --- +-- --- ...
... --- -7- --- $)) =-- --- ... --- <>> $\\ <>> --- ... --- =-- $)) --- --- --- ...
... ... --- ()) --- --- --- ### =-- --- <>> --- =-- ### --- --- --- ()) --- ... ...
--- --- ()) /\\ --- +-- =-- =-- ### ... =-- ... ### =-- =-- +-- --- /\\ ()) --- ---
... --- --- --- ()) $)) ### =-- --- --- =-- --- --- =-- ### $)) ()) --- --- --- ...
... --- ... ### --- --- $)) +-- --- =-- =-- =-- --- +-- $)) --- -4- ### ... --- ...
... ... ... --- --- -6- ()) --- --- $)) ### $)) --- --- ()) --- --- --- ... ... ...
... ... ... ... --- ### --- /\\ ()) --- --- --- ()) /\\ --- ### --- ... ... ... ...
... ... ... ... ... ... --- ()) --- --- +-- -5- --- ()) --- ... ... ... ... ... ...
... ... ... ... ... --- --- --- ... --- --- --- ... --- --- --- ... ... ... ... ...
... ... ... ... ... ... ... --- ... ... ... ... ... --- ... ... ... ... ... ... ...
