$\\ ... ... ... ... ...
... $\\ ... ... ... ...
<>> --- ... ... ... ...
=-- ... ### ... ... ...
=-- ... --- ... ... ...
=-- =-- --- +-- ... ...
### $)) &&& --- ... ...
--- --- ()) /\\ ()) ###
+-- -2- --- ()) ()) ())
--- --- ... --- --- ---

